#	#	#	#	#	#	#	#	#	#	#	#	#	#	#	#	#	#	#	#	#	#	#	#	#	#	#	#	#	#
#	.	.	.	.	.	.	.	.	.	.	.	.	.	.	.	.	.	.	.	.	.	.	.	.	.	.	.	.	#
#	.	.	.	.	.	.	.	.	.	.	.	.	.	.	.	.	.	.	.	.	.	.	.	.	.	.	.	.	#
#	.	.	.	.	.	.	.	.	.	.	.	.	.	.	.	.	.	.	.	.	.	.	.	.	.	.	.	.	#
#	.	.	.	.	.	.	.	.	.	.	.	.	.	.	.	.	.	.	.	.	.	.	.	.	.	.	.	.	#
#	.	.	.	.	.	.	.	.	.	.	.	.	.	.	.	.	.	.	.	.	.	.	.	.	.	.	.	.	#
#	.	.	.	.	.	.	.	.	#	#	#	#	#	#	.	#	#	#	#	#	.	.	.	.	.	.	.	.	#
#	.	.	.	.	.	.	.	.	#	.	.	.	.	.	.	.	.	.	.	#	.	.	.	.	.	.	.	.	#
#	.	.	.	.	.	.	.	.	#	.	.	.	.	.	.	.	.	.	.	#	.	.	.	.	.	.	.	.	#
#	.	.	.	.	.	.	.	.	#	.	.	.	.	.	.	.	.	.	.	#	.	.	.	.	.	.	.	.	#
<	.	.	.	.	.	.	.	.	.	.	.	.	.	.	.	.	.	.	.	.	.	.	.	.	.	.	.	.	>
#	.	.	.	.	.	.	.	.	#	.	.	.	.	.	.	.	.	.	.	#	.	.	.	.	.	.	.	.	#
#	.	.	.	.	.	.	.	.	#	.	.	.	.	.	.	.	.	.	.	#	.	.	.	.	.	.	.	.	#
#	.	.	.	.	.	.	.	.	#	#	#	#	#	#	.	#	#	#	#	#	.	.	.	.	.	.	.	.	#
#	.	.	.	.	.	.	.	.	.	.	.	.	.	.	.	.	.	.	.	.	.	.	.	.	.	.	.	.	#
#	.	.	.	.	.	.	.	.	.	.	.	.	.	.	.	.	.	.	.	.	.	.	.	.	.	.	.	.	#
#	.	.	.	.	.	.	.	.	.	.	.	.	.	.	.	.	.	.	.	.	.	.	.	.	.	.	.	.	#
#	.	.	.	.	.	.	.	.	.	.	.	.	.	.	.	.	.	.	.	.	.	.	.	.	.	.	.	.	#
#	.	.	.	.	.	.	.	.	.	.	.	.	.	.	.	.	.	.	.	.	.	.	.	.	.	.	.	.	#
#	#	#	#	#	#	#	#	#	#	#	#	#	#	#	#	#	#	#	#	#	#	#	#	#	#	#	#	#	#
