#	#	#	#	#	#	#	#	#	#	#	#	#	#	#	#	#	#	#	#	#	#	#	#	#	#	#	#	#	#
#	.	.	.	.	.	.	.	.	.	.	.	.	.	.	.	.	.	.	.	.	.	.	.	.	.	.	.	.	#
#	.	.	.	.	.	.	.	.	.	.	.	.	.	.	.	.	.	.	.	.	.	.	.	.	.	.	.	.	#
#	.	.	.	.	.	.	.	.	.	.	.	.	.	.	.	.	.	.	.	.	.	.	.	.	.	.	.	.	#
#	.	.	.	.	.	.	.	.	.	.	.	.	.	.	.	.	.	.	.	.	.	.	.	.	.	.	.	.	#
#	.	.	.	.	.	.	.	.	.	.	.	.	.	.	.	.	.	.	.	.	.	.	.	.	.	.	.	.	#
#	.	.	.	.	.	.	.	.	#	#	#	#	#	#	.	#	#	#	#	#	.	.	.	.	.	.	.	.	#
#	.	.	.	.	.	.	.	.	#	.	.	.	.	.	.	.	.	.	.	#	.	.	.	.	.	.	.	.	#
#	.	.	.	.	.	.	.	.	#	.	.	.	.	.	.	.	.	.	.	#	.	.	.	.	.	.	.	.	#
#	.	.	.	.	.	.	.	.	#	.	.	.	.	.	.	.	.	.	.	#	.	.	.	.	.	.	.	.	#
#	.	.	.	.	.	.	.	.	.	.	.	.	.	.	.	.	.	.	.	.	.	.	.	.	.	.	.	.	>
#	.	.	.	.	.	.	.	.	#	.	.	.	.	.	.	.	.	.	.	#	.	.	.	.	.	.	.	.	#
#	.	.	.	.	.	.	.	.	#	.	.	.	.	.	.	.	.	.	.	#	.	.	.	.	.	.	.	.	#
#	.	.	.	.	.	.	.	.	#	#	#	#	#	#	.	#	#	#	#	#	.	.	.	.	.	.	.	.	#
#	.	.	.	.	.	.	.	.	.	.	.	.	.	.	.	.	.	.	.	.	.	.	.	.	.	.	.	.	#
#	.	.	.	.	.	.	.	.	.	.	.	.	.	.	.	.	.	.	.	.	.	.	.	.	.	.	.	.	#
#	.	.	.	.	.	.	.	.	.	.	.	.	.	.	.	.	.	.	.	.	.	.	.	.	.	.	.	.	#
#	.	.	.	.	.	.	.	.	.	.	.	.	.	.	.	.	.	.	.	.	.	.	.	.	.	.	.	.	#
#	.	.	.	.	.	.	.	.	.	.	.	.	.	.	.	.	.	.	.	.	.	.	.	.	.	.	.	.	#
#	#	#	#	#	#	#	#	#	#	#	#	#	#	#	#	#	#	#	#	#	#	#	#	#	#	#	#	#	#
