 	 	#	#	#	#	#	#	#	#	#	#	#	#	#	#	#	#	#	#	#	#	#	#	#	 	 	 	 	 
 	 	#	.	.	.	.	.	.	.	.	.	.	.	.	.	.	.	.	.	.	.	.	.	#	 	 	 	 	 
#	#	#	.	.	.	.	.	.	.	.	.	.	.	.	.	.	.	.	.	.	.	.	.	#	 	 	 	 	 
#	.	.	.	.	.	.	.	.	.	.	.	.	.	.	.	.	.	.	.	.	.	.	.	#	 	 	 	 	 
#	.	.	.	.	.	.	.	.	.	.	.	.	.	.	.	.	.	.	.	.	.	.	.	#	 	 	 	 	 
#	.	.	.	.	.	.	.	.	.	.	.	.	.	.	.	.	.	.	.	.	.	.	.	#	#	#	#	#	#
#	.	.	.	.	.	.	.	.	#	#	#	#	#	#	.	#	#	#	#	#	.	.	.	.	.	.	.	.	#
#	.	.	.	.	.	.	.	.	#	.	.	.	.	.	.	.	.	.	.	#	.	.	.	.	.	.	.	.	#
#	.	.	.	.	.	.	.	.	#	.	.	.	.	.	.	.	.	.	.	#	.	.	.	.	.	.	.	.	#
#	.	.	.	.	.	.	.	.	#	.	.	.	.	.	.	.	.	.	.	#	.	.	.	.	.	.	.	.	#
<	.	.	.	.	.	.	.	.	.	.	.	.	.	.	.	.	.	.	.	.	.	.	.	.	.	.	.	.	>
#	.	.	.	.	.	.	.	.	#	.	.	.	.	.	.	.	.	.	.	#	.	.	.	.	.	.	.	.	#
#	.	.	.	.	.	.	.	.	#	.	.	.	.	.	.	.	.	.	.	#	.	.	.	.	.	.	.	.	#
#	.	.	.	.	.	.	.	.	#	#	#	#	#	#	.	#	#	#	#	#	.	.	.	.	.	.	.	.	#
#	#	#	#	#	#	.	.	.	.	.	.	.	.	.	.	.	.	.	.	.	.	.	.	.	.	.	.	.	#
 	 	 	 	 	#	.	.	.	.	.	.	.	.	.	.	.	.	.	.	.	.	.	.	.	.	.	.	.	#
 	 	 	 	 	#	.	.	.	.	.	.	.	.	.	.	.	.	.	.	.	.	.	.	.	.	.	.	.	#
 	 	 	 	 	#	.	.	.	.	.	.	.	.	.	.	.	.	.	.	.	.	.	.	.	.	.	#	#	#
 	 	 	 	 	#	.	.	.	.	.	.	.	.	.	.	.	.	.	.	.	.	.	.	.	.	.	#	 	 
 	 	 	 	 	#	#	#	#	#	#	#	#	#	#	#	#	#	#	#	#	#	#	#	#	#	#	#	 	 
