 	 	#	#	#	#	#	#	#	#	#	#	#	#	#	#	#	#	#	#	#	#	#	#	#	 	 	 	 	 
 	 	#	.	.	.	.	.	.	.	.	.	.	.	.	.	.	.	.	.	.	.	.	.	#	 	 	 	 	 
#	#	#	.	.	.	.	.	.	.	.	.	.	.	.	.	.	.	.	.	.	.	.	.	#	 	 	 	 	 
#	.	.	.	.	.	.	.	.	.	.	.	.	.	.	.	.	.	.	.	.	.	.	.	#	 	 	 	 	 
#	.	.	.	.	.	.	.	.	.	.	.	.	.	.	.	.	.	.	.	.	.	.	.	#	 	 	 	 	 
#	.	.	.	.	.	.	.	.	.	.	.	.	.	.	.	.	.	.	.	.	.	.	.	#	#	#	#	#	#
#	.	.	.	.	.	.	.	.	#	#	#	#	#	#	#	#	#	#	#	#	.	.	.	.	.	.	.	.	#
#	.	.	.	.	.	.	.	.	#	.	.	.	.	.	.	.	.	.	.	#	.	.	.	.	.	.	.	.	#
#	.	.	.	.	.	.	.	.	#	.	.	.	.	.	.	.	.	.	.	#	.	.	.	.	.	.	.	.	#
#	.	.	.	.	.	.	.	.	#	.	.	.	.	.	.	.	.	.	.	#	.	.	.	.	.	.	.	.	#
<	.	.	.	.	.	.	.	.	|	.	.	.	.	.	.	.	.	.	.	#	.	.	.	.	.	.	.	.	#
#	.	.	.	.	.	.	.	.	#	.	.	.	.	.	.	.	.	.	.	#	.	.	.	.	.	.	.	.	#
#	.	.	.	.	.	.	.	.	#	.	.	.	.	.	.	.	.	.	.	#	.	.	.	.	.	.	.	.	#
#	.	.	.	.	.	.	.	.	#	#	#	#	#	#	#	#	#	#	#	#	.	.	.	.	.	.	.	.	#
#	#	#	#	#	#	.	.	.	.	.	.	.	.	.	.	.	.	.	.	.	.	.	.	.	.	.	.	.	#
 	 	 	 	 	#	.	.	.	.	.	.	.	.	.	.	.	.	.	.	.	.	.	.	.	.	.	.	.	#
 	 	 	 	 	#	.	.	.	.	.	.	.	.	.	.	.	.	.	.	.	.	.	.	.	.	.	.	.	#
 	 	 	 	 	#	.	.	.	.	.	.	.	.	.	.	.	.	.	.	.	.	.	.	.	.	.	#	#	#
 	 	 	 	 	#	.	.	.	.	.	.	.	.	.	.	.	.	.	.	.	.	.	.	.	.	.	#	 	 
 	 	 	 	 	#	#	#	#	#	#	#	#	#	#	#	#	#	#	#	#	#	#	#	#	#	#	#	 	 
